11111111111111111111
1100000c100000000c01
1p00c100100c00010001
111111000001000100c1
1000c000000000010011
1c000000c0c0c001c0E1
11111111111111111111