11111111111111111111
1100000C100000000C01
1P00C100100C00010001
111111000001000100C1
1000C000000000010011
1C000000C0C0C001C0E1
11111111111111111111