111111111
110000001
1000111111
1P00C101
1CCCCCCE1
111111111